NO textures/colorstone.xpm
SO textures/greystone.xpm
WE textures/redbrick.xpm
EA textures/wood.xpm

F 0,225,200
C 0,0,200

1111
1011
1N1
111
