NO textures/colorstone.xpm
SO textures/greystone.xpm
WE textures/redbrick.xpm
EA textures/wood.xpm

F 0,100,0
C 225,30,255

        1111111111111111111111111
        1000000000110000000000001
        1011000001110000000000001
        1001000000000000S00000001
111111111011000001110000000000001
100000000011000001110000000011111
11110111111111011100000010001
11110111111111011101010010001
11000000110101011100000010001
10000000000000001100000010001
10000000000000001101010010001
1100000111010101111101111000011
11111111 1110101 101111010001
11111111 1111111 111111111111
