NO textures/Ceramic.xpm
SO textures/Desert_1.xpm
WE textures/Desert_2.xpm
EA textures/Desert_3.xpm

F 0,100,0
C 225,30,255

111111
1E0011
100001
100001
100001
100001
111111
